Accounts=Accounts
Accounts that will expire: 56=Accounts die zullen verlopen: 56
Add=Toevoegen
Add AGB Suppliers=Toevoegen AGB Leveranciers
Add Agb Suppliers Load DVCombo=Toevoegen AGB Leveranciers Load DVCombo
Add Gen Suppliers Load DVCombo=Toevoegen Leveranciers - Algemeens Load DVCombo
Add new item=Toevoegen Nieuw item
Add Products to Cart=Toevoegen Producten aan Winkelwagen
Add Suppliers=Toevoegen Leveranciers
Add Suppliers Load DVCombo=Toevoegen Leveranciers Load DVCombo
Add Suppliers Step1=Toevoegen Leveranciers Stap1
Add Suppliers Step2=Toevoegen Leveranciers Stap2
Address=Adres
AGB Suppliers=AGB Leveranciers
All=Alle
App Name=App Naam
Application Name=Applicatie Naam
Available=Beschikbaar
Birthday=Verjaardag
BLOWFISH=BLOWFISH
Bookmark=Bookmark
Bookmark Manager=Bookmark Manager
Bsn Number=BSN Nummer
Cancel=Annuleer
Center=Centrum
Change password=Verander Wachtwoord
CHANGE PASSWORD=Verander Wachtwoord
Check User Activation Method=Check Gebruiker Activation Method
Column Selector - Update Columns=Column Selector - Update Columns
Columns Selector - Add Columns=Columns Selector - Toevoegen Columns
Comforta=Comforta
Comforta Manager,Customer Manager,Receptionist,Resident=Comforta Manager,Klant Manager,Receptionist,Resident
Comming Soon=Binnenkort beschikbaar
Company Name=Organisatie Naam
Confirm Password=Bevestig Wachtwoord
Connect=Verbinden
Contact Name=Contact Naam
Contact Phone=Contact Telefoon
Create Customer=Toevoegen Klant
Create Resident=Toevoegen Resident
Create User Account=Toevoegen Gebruiker Account
Current Password=Huidig Wachtwoord
Custom Range Picker=Custom Range Picker
Custom Web Component=Custom Web Component
Customer=Klant
Customer Email=Klant Email
Customer Id=Klant Id
Customer Information=Klant Informatie
Customer Kvk Number=Klant Kvk Nummer
Customer Location Email=Klant Locatie Email
Customer Location Id=Klant Locatie Id
Customer Location Phone=Klant Locatie Telefoon
Customer Location Receptionist Given Name=Klant Locatie Receptionist Voornaam
Customer Location Receptionist Id=Klant Locatie Receptionist Id
Customer Location Receptionist Initials=Klant Locatie Receptionist Initialen
Customer Location Receptionist Last Name=Klant Locatie Receptionist Achternaam
Customer Location Receptionist Phone=Klant Locatie Receptionist Telefoon
Customer Locations=Klant Locaties
Customer Manager=Klant Manager
Customer Manager Email=Klant Manager Email
Customer Manager Given Name=Klant Manager Voornaam
Customer Manager Id=Klant Manager Id
Customer Manager Initials=Klant Manager Initialen
Customer Manager Last Name=Klant Manager Achternaam
Customer Manager Phone=Klant Manager Telefoon
Customer Name=Klant Naam
Customer Phone=Klant Telefoon
Customer Type=Klant Type
Customer Type Customer WC=Klant Type Klant WC
Customer Type Id=Klant Type Id
Customer Type Name=Klant Type Naam
Customer Type View=Klant Type Weergave
Customer Vat Number=Klant BTW Nummer
Customer WWGet Filter Data=Klant WWGet Filter Data
Customizations Id=Customizations Id
Customizations Key=Customizations Key
Customizations Value=Customizations Value
Dashboard=Dashboard
Debug=Debug
Decode QRCode=Decode QRCode
Delete=Verwijderen
Delete item=Verwijder item
Description=Omschrijving
Display=Weergeven
Download Report=Rapport Downloaden
Download to disk=Op Schijf Bewaren
DVMessage Get Advanced Notification=DVBericht Get Advanced Neetification
DVMessage Get Basic Notification Msg=DVBericht Get Basic Neetification Msg
Email=Email
EMail=EMail
Empty=Leeg
Error=Fout
Error uploading Spreadsheet:=Fout uploaden Spreadsheet:
Export Type=Export Type
fade=fade
False=False
File=File
Filter Full Text=Volledige tekst filteren
Financial Partners=FinanciÃ«le Partners
First Name=Voornaam
fontawesome=fontawesome
Gender=Geslacht
General Suppliers=Leveranciers - Algemeen
Generate=Genereren
Generate QRCode Image=Genereer QR-code afbeelding
Generic Suppliers=Leveranciers - Algemeen
Get=Krijgen
Get Dashboard Items=Krijg dashboarditems
Get Design System Settings=Get Design System Instellingen
Get Filter By Name=Get Filter By Naam
Get Home Modules Sample=Get Home Modules Voorbeeld
Get Logged In Customer Manager Id=Get Logged In Klant Manager Id
Get Logged In User=Get Logged In Gebruiker
Get Logged In User Customer Id=Get Logged In Gebruiker Klant Id
Get Menu Authorized Options Recursive=Get Menu Authorized Opties Recursive
Get Name Initials=Get Naam Initialen
Get Receptionist Location Id=Get Receptionist Locatie Id
Get WWPTitle Settings Icons=Get WWPTitel Instellingen Icons
Given Name=Voornaam
Go Back=Terug
Go To=Ga naar
Go to Customer Type=Go to Klant Type
Go to Product Service=Go to Product Service
Go to Product Service Type=Go to Product Service Type
Go to Resident Type=Go to Resident Type
Go to Supplier_Agb=Go to Leverancier_AGB
Go to Supplier_Gen=Go to Leverancier_Gen
Icon And Title=Pictogram en titel
Id=Id
Image Auth Type=Image Auth Type
Import=Importeren
INCompany=INOrganisatie
INCompany Id=INOrganisatie Id
INCompany Name=INOrganisatie Naam
INCompany Phone=INOrganisatie Telefoon
Info=Info
Informal Network (Companies)=Mantelzorgers (Organisaties)
Informal Network (Individuals)=Mantelzorgers (Personen)
Information=Informatie
INIndividual=INIndividual
INIndividual Id=INIndividual Id
Initialize Gam Roles=Initialize Gam Rollen
Initials=Initialen
Insert=Invoegen
Is Authorized By Functionality=Is geautoriseerd door functionaliteit
Is Sidebar Authorized Option=Is zijbalk geautoriseerde optie
Issues=Problemen
Keep Me Logged In=Blijf aangemeld
Kv KNumber=Kv KNummer
Kvk Number=Kvk Nummer
KvKNumber=KvKNummer
Last Name=Achternaam
Left=Links
Load Columns Selector State=Load Columns Selector State
Load Filters State=Load Filters State
Load Manage Filters State=Load Manage Filters State
Load User Key Value=Load Gebruiker Key Value
Load Work With Plus Context=Load Work With Plus Context
local=lokaal
Location=Locatie
Location Email=Locatie Email
Location Id=Locatie Id
Location Option=Locatie Optie
Location Receptionist Email=Locatie Receptionist Email
Log on to=Aanmelden bij
Login=Aanmelden
Logo App Client=Logo App Client
Man=Man
Manager=Manager
Manager Id=Manager Id
Manager Information=Manager Informatie
Manager Initials=Manager Initialen
Map Title=Map Titel
Master Page=Master Page
Master Page Frame=Master Page Frame
Master Unanimo Sidebar=Master Unanimo Sidebar
Message=Bericht
Missing=Ontbreekt
Name=Naam
Name Auth Type=Naam Auth Type
Name must be unique=Naam moet uniek zijn
Never=Nooit
New Password=Nieuw Wachtwoord
No=Nee
No specify=Nee toelichten
No Specify=Nee toelichten
NOEKEON=NOEKEON
NONE=Geen
Not Authorized=Niet Geautoriseerd
Number=Nummer
One Block=One Block
Opened Issues: 24=Opened Issues: 24
Option Link=Optie Link
Option Title=Optie Titel
Options=Opties
Ordered=Besteld
Other=Overigen
Password=Wachtwoord
Password Conf=Wachtwoord Conf
Patch=Patch
Payments=Betalingen
Pending receipts=In afwachting van ontvangst
Phone=Telefoon
Picker Dummy Variable=Picker Dummy Variable
Picture=Afbeelding
Post=Post
Postal Address=Postadres
Product Service=Producten Diensten
Product Service Description=Product Service Omschrijving
Product Service General=Product Service Algemeen
Product Service Id=Product Service Id
Product Service Load DVCombo=Product Service Load DVCombo
Product Service Name=Product Service Naam
Product Service Picture=Product Service Afbeelding
Product Service Product Service Resident WC=Product Service Product Service Resident WC
Product Service Product Service Supplier_Agb WC=Product Service Product Service Leverancier_AGB WC
Product Service Product Service Supplier_Gen WC=Product Service Product Service Leverancier_Gen WC
Product Service Quantity=Product Service Hoeveelheid
Product Service Type=Producten Diensten Type
Product Service Type General=Product Service Type Algemeen
Product Service Type Id=Product Service Type Id
Product Service Type Name=Product Service Type Naam
Product Service Type Product Service WC=Product Service Type Product Service WC
Product Service Type View=Product Service Type Weergave
Product Service Type WWGet Filter Data=Product Service Type WWGet Filter Data
Product Service View=Product Service Weergave
Product Service WWGet Filter Data=Product Service WWGet Filter Data
Products / Services=Producten / Services
Progress Bar=Voortgangsbalk
Progress Circle=Voortgangscirkel
Prompt Master Page=Prompt Master Page
Put=Put
QRCode Image=QR-code afbeelding
Quantity=Hoeveelheid
Receptionist=Receptionist
Receptionist Id=Receptionist Id
Receptionists=Receptionisten
Record Created=Bestand Toegevoegd
Record Creation Canceled=Bestand Toevoegen Geannuleerd
Record Deleted=Bestand Verwijderd
Record Updated=Bestand Geactualiseerd
Recover Password=Wachtwoord Herstellen
Register user=Gebruiker Registreren
Regular=Normaal
Remember Me=Herinner Mij
Remote Login=Op Afstand Aanmelden
Repository:=Repository:
Reset=Reset
Resident=Resident
Resident Email=Resident Email
Resident GAMGUID=Resident GAMGUID
Resident Given Name=Resident Voornaam
Resident Id=Resident Id
Resident INCompany Id=Resident INOrganisatie Id
Resident INCompany Kvk Number=Resident INOrganisatie Kvk Nummer
Resident INCompany Name=Resident INOrganisatie Naam
Resident INCompany Phone=Resident INOrganisatie Telefoon
Resident Information=Resident Informatie
Resident INIndividual Bsn Number=Resident INIndividual BSN Nummer
Resident INIndividual Gender=Resident INIndividual Geslacht
Resident INIndividual Given Name=Resident INIndividual Voornaam
Resident INIndividual Id=Resident INIndividual Id
Resident INIndividual Last Name=Resident INIndividual Achternaam
Resident INIndividual Phone=Resident INIndividual Telefoon
Resident Initials=Resident Initialen
Resident Last Name=Resident Achternaam
Resident Load DVCombo=Resident Load DVCombo
Resident Phone=Resident Telefoon
Resident Type=Bewoner Type
Resident Type General=Resident Type Algemeen
Resident Type Id=Resident Type Id
Resident Type Name=Resident Type Naam
Resident Type Resident WC=Resident Type Resident WC
Resident Type View=Resident Type Weergave
Resident Type WWGet Filter Data=Resident Type WWGet Filter Data
Resources/Qrcode.png=Resources/Qrcode.png
Right=Right
Roles Descriptions=Rollen Omschrijvingen
Rows=Rows
Sample=Voorbeeld
Save Columns Selector State=Save Columns Selector State
Save Grid State=Save Grid State
Save User Key Value=Save Gebruiker Key Value
Scanned Value=Scanned Value
SEED=SEED
Select file to import=Selecteer bestand voor importeren
Select Location=Select Locatie
Selection List Customer=Selection List Klant
Selection List Customer Type=Selection List Klant Type
Selection List INCompany=Selection List INOrganisatie
Selection List INIndividual=Selection List INIndividual
Selection List Location=Selection List Locatie
Selection List Manager=Selection List Manager
Selection List Product Service=Selection List Product Service
Selection List Product Service Type=Selection List Product Service Type
Selection List Receptionist=Selection List Receptionist
Selection List Resident=Selection List Resident
Selection List Resident Type=Selection List Resident Type
Selection List Supplier_Agb=Selection List Leverancier_AGB
Selection List Supplier_AGB=Selection List Leverancier_AGB
Selection List Supplier_Gen=Selection List Leverancier_Gen
Service Description=Service Omschrijving
Service Id=Service Id
Service Name=Service Naam
Service Picture=Service Afbeelding
Service Quantity=Service Hoeveelheid
Settings=Instellingen
show=toon
Sidebar Items DP=Sidebar Items DP
Sign in with %1=Sign in with {0}
Single Date Picker=Single Date Picker
Single Sign-On=Single Sign-On
SKIPJACK=SKIPJACK
slide=schuif
Step Description=Stap Omschrijving
Step Title=Stap Titel
Success=Succes
Supplier Name=Leverancier Naam
Supplier_Agb=Leverancier_AGB
Supplier_AGB=Leverancier_AGB
Supplier_Agb Contact Name=Leverancier_AGB Contact Naam
Supplier_Agb Email=Leverancier_AGB Email
Supplier_Agb General=Leverancier_AGB Algemeen
Supplier_Agb Id=Leverancier_AGB Id
Supplier_Agb Kvk Number=Leverancier_AGB Kvk Nummer
Supplier_Agb Load DVCombo=Leverancier_AGB Load DVCombo
Supplier_Agb Name=Leverancier_AGB Naam
Supplier_Agb Number=Leverancier_AGB Nummer
Supplier_Agb Phone=Leverancier_AGB Telefoon
Supplier_Agb Product Service WC=Leverancier_AGB Product Service WC
Supplier_Agb Supplier_Agb Customer WC=Leverancier_AGB Leverancier_AGB Klant WC
Supplier_Agb View=Leverancier_AGB Weergave
Supplier_Agb WWGet Filter Data=Leverancier_AGB WWGet Filter Data
Supplier_Gen=Leverancier_Gen
Supplier_Gen Company Name=Leverancier_Gen Organisatie Naam
Supplier_Gen Contact Name=Leverancier_Gen Contact Naam
Supplier_Gen Contact Phone=Leverancier_Gen Contact Telefoon
Supplier_Gen General=Leverancier_Gen Algemeen
Supplier_Gen Id=Leverancier_Gen Id
Supplier_Gen Kv KNumber=Leverancier_Gen Kv KNummer
Supplier_Gen Load DVCombo=Leverancier_Gen Load DVCombo
Supplier_Gen Product Service WC=Leverancier_Gen Product Service WC
Supplier_Gen Supplier_Gen Customer WC=Leverancier_Leveranciers - Algemeen_Gen Klant WC
Supplier_Gen View=Leverancier_Gen Weergave
Supplier_Gen WWGet Filter Data=Leverancier_Gen WWGet Filter Data
TableContainerUnderlineExtraBullet=TableContainerUnderlineExtraBullet
TableContainerUnderlineExtraBullet hidden-sm hidden-lg hidden-md=TableContainerUnderlineExtraBullet hidden-sm hidden-lg hidden-md
TEA=TEA
The document was succesully uploaded to Google Drive=The document was succesully uploaded to Google Drive
Title=Titel
Token:=Token:
Trace=Trace
True=Waar
Two Blocks=Two Blocks
TWOFISH=TWOFISH
Type=Type
Type Auth Type=Type Auth Type
Type Id=Type Id
Type Name=Type Naam
up to %1=up to {0}
Update=Bijwerken
Update register user=Update register user
Upload to Google Drive=Upload to Google Drive
URL=URL
User=Gebruiker
User Custom=Gebruiker Custom
User Image=Gebruiker Foto
User Name=Gebruiker Naam
User Password=Gebruiker Wachtwoord
User Password New=Gebruiker Wachtwoord Nieuw
User Password New Conf=Gebruiker Wachtwoord Nieuw Conf
UserCustomizations=GebruikerCustomizations
VAT=BTW
Vat Number=BTW Nummer
Visiting Address=Bezoekadres
Warning=Waarschuwing
Wizard Step Title=Wizard Stap Titel
Wizard Steps Arrow WC=Wizard Staps Arrow WC
Wizard Steps Bullet WC.=Wizard Staps Bullet WC.
Wizard Steps Underline WC=Wizard Staps Underline WC
Wizard Steps Vertical WC=Wizard Staps Vertical WC
Woman=Vrouw
Yes=Ja
none=Geen
WWP_EditColumnsCaption=Selecteer Kolommen
WWP_Studios=Studios
WWP_GroupByOption=Group column
WWP_CloseAllTabs=Close all tabs
WWP_SaveFilterAsDescription=Save filter as...
WWP_PressSearchToShowData=Press Search to show data
WWP_TSColumnOptions=Column options
WWP_IncludeDeveloperMenu=Show Developer Menu
WWP_PagingNextCaption=Volgende
WWP_ImportData=Import
WWP_MultipleSelectionEmptyItem=(None)
WWP_CleanFiltersTooltip=Clear filters
WWP_ImportFile_ErrorImportingTitle=Error importing file
WWP_DynFilterPrefix=Search in
WWP_ColumnSelectorFixedRightCategory=Aan de rechterkant bevestigd
WWP_ColumnSelectorFixedEmpty=(Geen)
WWP_Search_ShowingTopResults=Showing the first {0} results
WWP_ActionNoLongerAvailable=Action no longer available
WWP_WordsListLastSeparator=and
WWP_RPTemplates_InvoiceTotal=Invoice Total
WWP_WizardFinishCaption=Finish
WWP_ExportTypeDescription=Export type
WWP_Search_AdvancedSearch=Advanced search
WWP_OrderedBy=Ordered by
WWP_ConfirmTextYes=Ja
WWP_DynFilterAddCaption=Add filter
WWP_SelectColumns_RestoreDefault=Restore default settings
WWP_TenantNameTitle=Tenant
WWP_FilterNotContains=Not contains
WWP_HideAdvancedFilters=Hide advanced filters
WWP_ExportReportCaption=PDF
WWP_FilterValueDescription_MultipleValues=multiple values
WWP_SearchMenuOption=Search menu option...
WWP_RPTemplates_Discount=Discount
WWP_ManageFiltersDescription=Filters manager
WWP_Notifications_NewDiscussionMessage=New discussion message
WWP_ExportReportTooltip=Export to PDF
WWP_ActionGroupDescription=Select an action
WWP_FilterLike=Starts with
WWP_FilterPast=Past
WWP_Discussions_Tooltip=Discussions
WWP_DataSuccessfulyUpdated=Data updated successfully
WWP_ResumeWizard_Text=This wizard has already been started. How would you want to proceed?
WWP_Bookmark_Edit=Edit bookmark for this page
WWP_AddGridLine=[[New row]]
WWP_FilterSelected=Filter Selected
WWP_GoogleDrivePassword=Password
WWP_Notifications_MarkAllAsRead=Mark all as read
WWP_LogoutCaption=Logout
WWP_ManageFiltersOption=Manage filters...
WWP_ActionGroupCaption=- Select an action -
WWP_TotalizerCount=CNT:
WWP_ImportCSVTooltip=Import CSV
WWP_NoRecordSelected=No record selected.
WWP_WordsListSeparator=,
WWP_DynFilterMiddle=value
WWP_PagingRowsPerPage=Rijen per pagina:
WWP_FilterYesterday=Yesterday
WWP_ResumeWizard_Title=Wizard started previously
WWP_TSSortASC=Sort from A to Z
WWP_TSSortDSC=Sort from Z to A
WWP_ColumnsSelectorVisible=Visible
WWP_MasterPage_Login=Login
WWP_WizardWelcomeCaption=Welcome to the Wizard
WWP_TSFrom=From
WWP_NotAssociatedRecords=Not Associated Records
WWP_TabWithCountCaption={0} ({1})
WWP_TSNoResults=- No results found -
WWP_FilteringByCaption=Filtering by {0}
WWP_FullTextFilterDescription=Main filter
WWP_PormptMultipleSelect=Select
WWP_NotAuthorizedTitle=Not Authorized
WWP_Parameter_Transaction_Description=Parameter
WWP_Rows50=50 rijen
WWP_Rows20=20 rijen
WWP_Rows10=10 rijen
WWP_CartEmpty=Your shopping cart is empty
WWP_CartItems=Items
WWP_StartNewThread=Start a new thread
WWP_GoogleDriveDocumentTitle=Document title
WWP_CartPrice=Price
WWP_CartTotal=Total
WWP_Search=Zoeken
WWP_FilterLastMonth=Last month
WWP_FilterGreaterThan0=Greater than 0
WWP_CloseOtherTabs=Close other tabs
WWP_GoogleDriveEmail=Email
WWP_DocumentSuccessfullyLoaded=The document was succesully uploaded to Google Drive
WWP_RPTemplates_InvoiceNumber2=Invoice #
WWP_SplitScreenNewRecordTabCaption=<New>
WWP_Notifications_CheckAllNotifications=Check all notifications >
WWP_TSCleanFilter=Clean search
WWP_MasterPage_Register=Register
WWP_Search_ShowingRecentSearchResults=Showing recent search results
WWP_RPTemplates_CustomerName=Customer Name
WWP_TSSearchButtonCaption=Search
WWP_TSRangePickerInviteMessage=Select a range
WWP_RPTemplates_Total=Total
WWP_BookmarkUrl=Url
WWP_Contact=Contact
WWP_TitleFilter_EmptyOption=(Empty)
WWP_FilterNextWeek=Next week
WWP_Customers=Customers
WWP_FilterNextYear=Next year
WWP_CartBuy=Buy
WWP_CartQty=Qty
WWP_Search_TypeToSearch=Type to search in the application or menu
WWP_ColumnSelectorFixedLeftCategory=Aan de linkerkant bevestigd
WWP_RPTemplates_Tax=Tax
WWP_Search_SearchDescription=Search
WWP_RPTemplates_BilledTo=Billed to
WWP_ColumnsSelectorButton=Update
WWP_TSChecked=Checked
WWP_FontSize_Dsc=Font Size
WWP_FilterTomorrow=Tomorrow
WWP_CartQuantity=Quantity
WWP_AddNewOption=New...
WWP_ParameterValue_Attribute_Description=Parameter Value
WWP_ConfirmTextNo=Nee
WWP_MiddleText=to
WWP_FilterSpecificDate=Specific date
WWP_ParameterCategory_Attribute_Description=Parameter Category
WWP_FiltersColumnName=Filters
WWP_ImportFile_ExpectedFileType=The expected file type is {0}.
WWP_HomeTitle=Thuis
WWP_FilterThisWeek=This week
WWP_FilterThisYear=This year
WWP_ParameterDescription_Attribute_Description=Parameter Description
WWP_CartProduct=Product
WWP_PagingLastCaption=Last
WWP_ColumnsSelectorColumns=Columns
WWP_ResumeWizard_NoButton=Start a new one
WWP_CleanFiltersCaption=Clear filters
WWP_PaginationBarGoToCaption=Go to page:
WWP_ConfirmTextCancel=Annuleer
WWP_BackgroundStyle_Dsc=Background Style
WWP_CopyRecordsTooltip=Copy Records
WWP_Bookmark_Add=Bookmark this page
WWP_BookmarkName=Name
WWP_ExportCaption=Excel
WWP_ImportExcelTooltip=Import Excel
WWP_FilterThisMonth=This month
WWP_ImportCSVCaption=Import CSV
WWP_NaturalLanguageQuery_Action_Tooltip=Search using natural language
WWP_Subscriptions_Tooltip_OneRecord=Subscriptions for this record
WWP_FilterOptions=Options
WWP_Rows5=5 rijen
WWP_Search_BasicSearch=Basic search
WWP_FilterNotExist=The selected filter no longer exist.
WWP_WizardGoToCaption=Edit
WWP_Services=Services
WWP_ParameterCategory_Attribute_ContextualTitle=Category
WWP_SelectAll=Select all
WWP_UserName=User name
WWP_TotalizerAvg=AVG:
WWP_TotalizerSum=SUM:
WWP_TotalizerMin=MIN:
WWP_TotalizerMax=MAX:
WWP_ExcelOptions_GoogleDriveInfo=Google Drive Information
WWP_Notifications_NewNotifications=U hebt {0} nieuwe meldingen.
WWP_OnlySelectedValues=Only selected values
WWP_Search_SearchInDescription=Search in
WWP_GroupedImport_ExcelCaption=Excel
WWP_Login_Welcome=Welcome!
WWP_WizardReturnToSummary=Return to summary
WWP_PagingEmptyGridCaption=Geen gegevens gevonden
WWP_Color_Dsc=Color
WWP_DynFilterRemoveCaption=Remove filter
WWP_Search_NoResults=No results found for '{0}'.
WWP_MasterPage_Search=Search...
WWP_ShowAdvancedFilters=Show advanced filters
WWP_RPTemplates_Date=Date
WWP_ColumnsSelectorDescription=Columns Selector
WWP_DynFilterAddTooltip=Add filter
WWP_ParameterKey_Attribute_ContextualTitle=Key
WWP_RPTemplates_InvoiceNumber=Invoice Number
WWP_ParameterValue_Attribute_ContextualTitle=Value
WWP_RequiredAttribute={0} is vereist.
WWP_AddressDisplayMap=Map
WWP_RPTemplates_Subtotal=Subtotal
WWP_ExportCSVCaption=CSV
WWP_ExportOptions_Where=Where to export?
WWP_AssociatedRecords=Associated Records
WWP_FilterInTheFuture=In the future
WWP_Search_ShowAll=Show all results for '{0}'...
WWP_ErrorUploadingSpreadSheet=Error uploading Spreadsheet:
WWP_FilterComboDifferent=Not Equals
WWP_Notifications_OneNewNotification=You have 1 new notification
WWP_Search_MenuOptions=Menu options
WWP_ColumnSelectorNoCategoryText=(No category)
WWP_RecordNotFound=Record niet gevonden
WWP_ColumnSelectorNotFixedCategory=Niet opgelost
WWP_PagingCaption=Page <CURRENT_PAGE> of <TOTAL_PAGES>
WWP_Subscriptions_Tooltip=Subscriptions
WWP_ParameterKey_Attribute_Description=Parameter Key
WWP_DynamicForms=Dynamische formulieren
WWP_TemplateDataPanelTitle=General Information
WWP_FilterComboEquals=Equals
WWP_Notifications_Manage=Manage my subscriptions
WWP_ExportData=Export
WWP_Notifications_MentionShortMessage=You were mentioned by {0} in a comment on {1}: {2}
WWP_Notifications_NoNewNotifications=Geen nieuwe meldingen
WWP_ExportOptionsDescription=Excel Export Options
WWP_PagingFirstCaption=First
WWP_AccountCaption=Account
WWP_AllInCombo=All
WWP_ImportExcelCaption=Import Excel
WWP_EditColumnsTooltip=Selecteer Kolommen
WWP_PagingPreviousCaption=Vorige
WWP_CopyRecordsCaption=Copy Records
WWP_WizardCompleted=Wizard Completed!
WWP_ExportCSVTooltip=Export to CSV
WWP_ExportTooltip=Export to Excel
WWP_PaginationBarGoToTooltip=Refresh
WWP_NoChangesMade=No changes made.
WWP_ManageFiltersTooltip=Manage filters
WWP_BackgroundStyle_Light=Light
WWP_SaveButtonCaption=Save
WWP_ParameterDescription_Attribute_ContextualTitle=Description
WWP_TSFixLeft=Fix to the left
WWP_TSLoading=Loading data...
WWP_FilterLastYear=Last year
WWP_FilterLastWeek=Last week
WWP_Bookmark_Tooltip=Bookmarks
WWP_FilterContains=Contains
WWP_Notifications_NoNotificationsReceived=You haven't received any notification yet
WWP_Notifications_NewDiscussionThread=New discussion thread
WWP_ImportFile_ImportSuccessTitle=File import success
WWP_ApplyFilterToShowData=Apply at least one filter to show data
WWP_WizardCompletedDescription=Congratulations! The wizard was completed successfully.
WWP_ChangePasswordCaption=Change Password
WWP_SaveFilterAsOption=Save filter as...
WWP_TF_FormattingSettings=Settings
WWP_DynFilterRemoveTooltip=Remove filter
WWP_TSUnChecked=Unchecked
WWP_IncludeEditMenuOptions=Show Edit Menu Options
WWP_GroupedImport_CSVCaption=CSV
WWP_StyleCustomizations=Style Customizations
WWP_TSFixRight=Fix to the right
WWP_RPTemplates_Invoice=INVOICE
WWP_FilterNextMonth=Next month
WWP_MainMenuNameRepeated=Another menu with the same name already exists
WWP_BackgroundStyle_Dark=Dark
WWP_ResumeWizard_YesButton=Resume
WWP_Notifications_NewMention=You were mentioned
WWP_FiltersName=Name
WWP_FilterEmpty=Empty
WWP_Notifications_NewMessageShortMessage={0} added a comment on {1}: {2}
WWP_FilterToday=Vandaag
WWP_FilterRange=Range
WWP_CloseButtonCaption=Close
WWP_More=More...
WWP_Home=Thuis
WWP_TSTo=To
WWP_Role=Role
WWP_Step=Step
WWP_PromptGeolocationSelect=Select Geolocation
WWP_BackofficeSamplePages=Backoffice Samples
Language=Taal
Add AGB Suppliers Load DVCombo=Toevoegen AGB Leveranciers Load DVCombo
BSN Number=BSN Nummer
Customer KVK-number=Klant KVK-nummer
Customer VAT Number=Klant BTW Nummer
Go to Supplier_AGB=Go to Leverancier_AGB
KVK-number=KVK-nummer
Product Service Product Service Supplier_AGB WC=Product Service Product Service Leverancier_AGB WC
Resident INCompany KVK-number=Resident INOrganisatie KVK-nummer
Resident INIndividual BSN Number=Resident INIndividual BSN Nummer
Supplier_AGB Contact Name=Leverancier_AGB Contact Naam
Supplier_AGB Email=Leverancier_AGB Email
Supplier_AGB General=Leverancier_AGB Algemeen
Supplier_AGB Id=Leverancier_AGB Id
Supplier_AGB KVK-number=Leverancier_AGB KVK-nummer
Supplier_AGB Load DVCombo=Leverancier_AGB Load DVCombo
Supplier_AGB Name=Leverancier_AGB Naam
Supplier_AGB Number=Leverancier_AGB Nummer
Supplier_AGB Phone=Leverancier_AGB Telefoon
Supplier_AGB Product Service WC=Leverancier_AGB Product Service WC
Supplier_AGB Supplier_Agb Customer WC=Leverancier_AGB Leverancier_AGB Klant WC
Supplier_AGB View=Leverancier_AGB Weergave
Supplier_AGB WWGet Filter Data=Leverancier_AGB WWGet Filter Data
Supplier_Gen KVK-number=Leverancier_Gen KVK-nummer
VAT Number=BTW Nummer
WWP_GAM_ChangeMyPassword=Verander mijn wachtwoord
WWP_GAM_ChangePassword=Wachtwoord wijzigen
WWP_GAM_Logout=Uitloggen
WWP_GAM_Login=Login
Agenda Calendar=Agenda Kalender
WWP_Calendar_All=Alle
WWP_Calendar_AllDay=Hele dag
WWP_Calendar_AllDayEvent=Hele dag evenement
WWP_Calendar_Clear=duidelijk
WWP_Calendar_CreateEvent=Activiteit Maken
WWP_Calendar_Date=Datum
WWP_Calendar_Delete Event=Gebeurtenis verwijderen
WWP_Calendar_DeleteEventMessage=Weet u zeker dat u dit evenement wilt verwijderen?
WWP_Calendar_DeleteEventTitle=Gebeurtenis verwijderen
WWP_Calendar_DurationEvent=Duur
WWP_Calendar_EventInBlockedDate=Het evenement kan niet op een geblokkeerde dag plaatsvinden
WWP_Calendar_From=Van
WWP_Calendar_FromDate=Vanaf datum
WWP_Calendar_Future=Toekomst
WWP_Calendar_TitleEvent=Titel
WWP_Calendar_Search=Zoeken
Customers=Klanten
Locations=Locaties
Residents=Bewoners
My Suppliers (AGB)=Mijn leveranciers (AGB)
My Suppliers (General)=Mijn leveranciers (Algemeen)
Add General Supplier=Algemene leverancier toevoegen
Add General Suppliers=Algemene leveranciers toevoegen
Customer Types=Klant Typen
Resident Types=Bewoner Typen
Product/Service Types=Producten/Diensten Type
Products/Services=Producten/Diensten
Page Templates=Pagina Sjablonen
Page Template=Pagina sjabloon
Page Template Description=Beschrijving
Page Template Image=Afbeelding
Page Template Name=Naam
Page Template Selector=Selectie
Page Template View=Weergave
New Page=Nieuwe pagina
Suppliers (Medical)=Leveranciers (Medisch)
Suppliers (Generic)=Leveranciers (Algemeen)
Products & Services=Producten en diensten
Amenities=Voorzieningen
Amenities General=Voorzieningen Algemeen
Amenities Type=Voorzieningen Type
Amenities Type Name=Voorzieningen Type Naam
Amenities Type View=Voorzieningen Type Uitzicht
Amenities View=Voorzieningen Bekijk
Contacts=Contacten
Mailbox=Postbus
My Profile=Mijn profiel
Chat=Praten
Create Location and Receptionists=Locatie en receptionisten aanmaken
Location Information=Locatie-informatie
Receptionist Information=Informatie receptioniste
Suppliers=Leveranciers
Step %1/%2 :: %3=Stap {0}/{1} : {2}
WWP_Calendar_NewEvent=Nieuw evenement
WWP_Calendar_To=Tot
Customization=Maatwerk
Agenda=Agenda
AGB Number=AGB Nummer
Location Amenities=Locatie Voorzieningen
KVK Number=KVK Nummer
KvkNumber=KVK Nummer
Application Design=Applicatie Ontwerp
Customer Type is required=Klant Type is vereist
Select Type=Selecteer Soort
Supplier Information=Leverancier-informatie
My General Suppliers=Mijn Algemeen Leveranciers
My AGB Suppliers=Mijn AGB Leveranciers
My Suppliers=Mijn leveranciers
Suppliers (General)=Leveranciers (Algemeen)
General Supplier=Leverancier - Algemeen
General=Algemeen
Product/Service=Producten/Diensten
Product/Service Type is required=Producten/Diensten is vereist
Product/Service already added=Producten/Diensten al toegevoegd
Customer Customization=Klantaanpassing
Font Size=Lettergrootte
Medium=Gemiddeld
Small=Klein
Large=Groot
Select Font Size=Selecteer lettergrootte
Customer Logo=Klantlogo
Customization Favicon=Aanpassing Favicon
Customization Logo=Aanpassing Logo
Color Theme=Kleurenthema
Select Color=Selecteer kleur
Selected=Gekozen
Select Option=Selecteer Optie
Select=Selecteer
Product Types=Product Typen
Product Service Types=Product Service Typen
Next=Volgende
Finish=Afronden
Supplier type deleted successfully=Leverancierstype succesvol verwijderd
Supplier type updated successfully=Leverancierstype succesvol bijgewerkt
Supplier Types=Leveranciers typen
Translated Type=Vertaalde typen
Category=Categorie
Translation=Vertaling
YOU HAVE 8 UNREAD NOTIFICATIONS=U heeft 8 Ongelezen Berichten
YOU HAVE=U heeft
Zip Code=Postcode
Address Line 1=Adresregel 1
Address Line 2=Adresregel 2
Address Line1=Adresregel 1
Address Line2=Adresregel 2
Account Status=Accountstatus
Action=Actie
Action Email=Actie Email
Active=Actief
Birth Date=Geboortedatum
Back=Terug
App Tile Name=App Tegelnaam
Address Information=Adres Informatie
Change Language=Verander Taal
Change Password=Verander Wachtwoord
Contact Person=Contactpersoon
Confirm=Bevestig
Agb Number=AGB Nummer
Create=Maken
Display Description=Weergave Omschrijving
Discussions=Discussies
deleted=Verwijderen
Action Id=Actie Id
Action Name=Actie Naam
Action Phone=Actie Telefoon
Action Type=Actie Type
Action Url=Actie URL
Validation=Validatie
City=Plaats
Clear Filters=Wis filters
Country=Land
Date=Datum
Date/Time=Datum / Tijd
Day=Dag
Element settings=Element Instellingen
WWP_DF_FormType=Formulier Type
General Information=Algemene Informatie
General Supplier Types=Algemene Leveranciers typen
Get notified when discussion messages are created=Krijg een melding wanneer er discussieberichten worden gemaakt
Home Phone=Thuis Telefoon
Image=Afbeelding
Inactive=Niet Actief
Invite=Uitnodigen
Is Main Manager=Is Hoofdmanager
Is Main Manager?=Is Hoofdmanager?
KvK number should contain 8 digits=KvK-nummer moet 8 cijfers bevatten
KvK Number should contain 8 digits=KvK-nummer moet 8 cijfers bevatten
Location forms=Locatie Formulieren
Male=Man
male=Man
female=Vrouw
Female=Vrouw
Medical Indication=Medische Indicatie
Medical Indication Id=Medische Indicatie Id
Medical Indication Name=Medische Indicatie Naam
Medical Indications=Medische Indicatie
Mentions=Vermeldingen
Messages=Berichten
Mobile Phone=Mobiele Telefoon
Month=Maand
mr=Dhr
Mr=Dhr
MR=Dhr
mrs=Mevr
Mrs=Mevr
Notifications=Meldingen
Organisation Manager=Organisatie Manager
Organisations=Organisaties
other=Overigen
Phone Code=Telefoon Code
Phone contains 9 digits=Telefoonnummer moet 9 cijfers bevatten
Plain=Eenvoudig
Read=Lezen
Receptionist Email=Receptionist Email
Receptionist Is Active=Receptionist is Actief
Reference Name=Referentie Naam
WWP_DF_ReferenceName=Referentie Naam
Resident Forms=Bewoner Formulieren
Select Category=Selecteer Categorie
select category=Selecteer Categorie
Select Supplier Type=Selecteer Leverancier Type
Short Description=Korte omschrijving
Table Name=Tabel naam
Today=Vandaag
UnRead=Ongelezen
Validations=Validaties
Wizard=Wizard
Zip Code is incorrect=Postcode is onjuist
Activation Date=Activatiedatum
Activation error -=Activeringsfout -
Activity=Activiteit
Add at least 1 main manager=Voeg minstens 1 hoofdmanager toe
Add New Medical Indication=Nieuwe medische indicatie toevoegen
Add New Organisation Type=Nieuw organisatietype toevoegen
Add New Resident Type=Nieuw residentietype toevoegen
Add recovery email=Herstel e-mailadres toevoegen
Add RSVP=Voeg RSVP toe
Address Group=Adresgroep
admin=admin
Add New AGB SupplierType=Nieuw AGB Leverancierstype toevoegen
Add New General Supplier=Nieuwe Algemene Leverancier toevoegen
Add New General Supplier Type=Nieuw Algemene Leverancierstype toevoegen
AGB Number should contain 8 digits=AGB nummer moet 8 cijfers bevatten
AGB Supplier=AGB Leverancier
Agb Supplier Types=AGB Leveranciers typen
AGB Supplier Types=AGB Leveranciers typen
Agb Suppliers=AGB Leverancier
Agb Phone=AGB Telefoon
AGENDA=AGENDA
All Day=De hele dag
Allow only users with verified email?=Alleen gebruikers met een geverifieerd e-mailadres toestaan?
Allow User Subscription=Gebruikersabonnement toestaan
Already activated?=Al geactiveerd?
Attachment File=Bijlage bestand
Attachment Name=Bijlage naam
Attachments=Bijlagen
Calendar=Kalender
Call us=Bel ons
Call Us=Bel ons
center=Centrum
Changes saved successfully.=Wijzigingen succesvol opgeslagen.
Check all notifications >=Controleer alle meldingen >
Check User Is Not Unsubscribed=Controleer of gebruiker niet is afgemeld
Create Location=Locatie aanmaken
Create Organisation=Organisatie aanmaken
Current Date=Huidige datum
Data=Gegevens
Data Name=Gegevensnaam
Date Of Birth=Geboortedatum
Date Filter=Datumfilter
Date Time=Datum en tijd
Daughter=Dochter
Datetime=Datumtijd
DELETE=VERWIJDEREN
Discussion Message=Discussiebericht
Discussion Message Thread=Discussieberichtthread
Edit=Bewerken
EDIT=Bewerken
Edit Receptionists=Receptiepersoneel bewerken
Element Title=Elementtitel
Email us=E-mail ons
Email Us=E-mail ons
End Date=Einddatum
File Name=Bestandsnaam
File Readonly=Bestand Alleen-lezen
File Type=Bestandstype
File upload=Bestand uploaden
fill out form=Formulier invullen
Fill Request Form=Vul het aanvraagformulier in
Filled forms=Ingevulde formulieren
Filter User Gender=Filter gebruikersgeslacht
Filtered Read Records:=Gefilterde gelezen records:
Filtered Unread Records:=Gefilterde ongelezen records:
First Registered=Eerste registratie
Fixed values=Vaste waarden
Form deleted successfully=Formulier succesvol verwijderd
Form Filled By=Formulier ingevuld door
Form Filled Date=Datum formulier ingevuld
Form Response Deleted=Formulierreactie verwijderd
Form Response Updated=Formulierreactie bijgewerkt
Form submitted successfully=Formulier succesvol ingediend
Form Submitted successfully=Formulier succesvol ingediend
Form Title=Formuliertitel
Form updated successfully=Formulier succesvol bijgewerkt
Form Version #=Formulier versie #
Form Version Number=Formulier versie nummer
Formatted text/html=Opgemaakte tekst/html
FormFilledMessage=FormulierIngevuldBericht
From=Van
Friend=Vriend
From Date Display=Weergave van begindatum
From Time=Vanaf tijd
Full Name=Volledige naam
GENERAL=Algemeen
General forms=Algemene formulieren
GeneralDiscussion=Algemene Discussie
Generation type=Generatietype
Get notified when a new calendar event is created=Ontvang een melding wanneer een nieuw agenda-item wordt aangemaakt
Get notified when a record of Product/Service is inserted=Ontvang een melding wanneer een record van Product/Dienst wordt ingevoerd
Get notified when this Product/Service is deleted=Ontvang een melding wanneer dit Product/Dienst wordt verwijderd
Get notified when this Product/Service is updated=Ontvang een melding wanneer dit Product/Dienst wordt bijgewerkt
Get notified when you are mentioned in a discussion=Ontvang een melding wanneer je wordt genoemd in een discussie
Get notified whenever a new discussion message comes in=Ontvang een melding wanneer er een nieuw discussiebericht binnenkomt
has delete their filled out form (=heeft hun ingevulde formulier verwijderd
Has Discussion Messages=Heeft discussieberichten
has updated their filled out form (=heeft hun ingevulde formulier bijgewerkt
Icon Category=Pictogramcategorie
Image Readonly=Afbeelding alleen-lezen
Include Notification=Inclusief melding
Include one option per line=Voeg Ã©Ã©n optie per regel toe
Insert ERROR=Fout invoegen
inserted=Ingevoegd
inserted.=Ingevoegd
Invalid Date Of Birth=Ongeldige geboortedatum
Invalid Delete Action: You cannot delete your own account.=Ongeldige verwijderactie: Je kunt je eigen account niet verwijderen.
Invalid email pattern=Ongeldig e-mailpatroon
Invalid website format=Ongeldig websiteformaat
Inverse Background=Omgekeerde achtergrond
Invisible=Onzichtbaar
Invitation sent=Uitnodiging verzonden
Invitation sent successfully=Uitnodiging succesvol verzonden
Invitation sent successfully.=Uitnodiging succesvol verzonden.
Is Active=Is actief
Is Predefined=Is vooraf gedefinieerd
is Preffered=Is voorkeur
Is Published=Is gepubliceerd
Is Read=Is gelezen
Is Received Web Notification=Is ontvangen webmelding
Is Wizard=Is Wizard
johndoe@gmail.com=johndoe@gmail.com
KVK number contains 8 digits=KVK-nummer bevat 8 cijfers
KVK number must contain 8 digits=KVK-nummer moet 8 cijfers bevatten
Label=Label
Last Registered=Laatst geregistreerd
Latest Version=Laatste versie
left=Links
Location Name=Locatienaam
Location Phone=Locatietelefoon
Location Phone Code=Locatie telefooncode
Location Phone Number=Locatietelefoonnummer
Location Receptionists=Locatie receptiemedewerkers
Location Residents=Locatie bewoners
Location:=Locatie:
Logger=Logger
Login Again=Log opnieuw in
Login/Name/Email=Inloggen/Naam/E-mail
Logo=Logo
Logout=Uitloggen
Manage my Subscriptions=Beheer mijn abonnementen
Manage Role's Subscriptions=Beheer de abonnementen van de rol
Manager Email=Manager e-mail
Manager Gender=Manager geslacht
Manager Given Name=Manager voornaam
Manager Last Name=Manager achternaam
Manager Phone=Manager telefoon
Manager Phone Code=Manager telefooncode
Manager Phone Number=Manager telefoonnummer
Managers=Managers
Mark as read=Markeren als gelezen
Mark as Read=Markeren als gelezen
Mark as unread=Markeren als ongelezen
Message Date=Berichtdatum
Message sent=Bericht verzonden
minute=Minuut
minutes=Minuten
miss=Mej
Miss=Mej
Mobile notifications=Mobiele meldingen
Mobile Notifications=Mobiele meldingen
Modified attributes:=Gewijzigde attributen:
Mother=Moeder
Move left=Naar links verplaatsen
Move right=Naar rechts verplaatsen
My Living=Mijn Wonen
my living=Mijn Wonen
my services=Mijn diensten
My Services=Mijn diensten
New Agenda Created=Nieuwe agenda aangemaakt
New Calendar Event=Nieuw agenda-item
New Filled Form=Nieuw ingevuld formulier
New Form Response=Nieuwe formulierreactie
New Service=Nieuwe service
No answers=Geen antwoorden
No forms filled=Geen formulieren ingevuld
No languages set=Geen talen ingesteld
No location record found!=Geen locatiegegevens gevonden!
No organisation record found!=Geen organisatiegegevens gevonden!
No resident record found!=Geen bewonersgegevens gevonden!
None=Geen
no-reply@comforta.yukon.software=no-reply@comforta.yukon.software
Normal=Normaal
Not Preferred=Niet voorkeur
Notification=Melding
Notification Created=Melding aangemaakt
Notification Created Date=Meldingsaanmaakdatum
Notification Date=Meldingsdatum
Notification Datetime=Meldingsdatum en tijd
Notification Definition=Meldingsdefinitie
Notification Definition Description=Meldings definitie beschrijving
Notification Description=Meldings beschrijving
Notification Detail=Melding detail
Notification Details=Melding details
Notification Link=Meldingslink
Notification Message...=Meldingsbericht...
Notification Processed=Melding verwerkt
Notification Read=Melding gelezen
Notification Received=Melding ontvangen
Notification Scheduled=Melding gepland
Notification Sent Successfully=Melding succesvol verzonden
Notification Short Description=Korte beschrijving van de melding
Notification Status=Meldingsstatus
Notification Text=Meldingstekst
Notification Title=Meldingstitel
Notification Topic=Meldingstopic
Notification Types=Meldingssoorten
notifications=meldingen
OFF=UIT
ON=AAN
Organisation=Organisatie
Organisation Name=Organisatienaam
Organisation Address Country=Organisatie adres land
Organisation Address Zip Code=Organisatie adres postcode
Organisation Email=Organisatie e-mail
Organisation Information=Organisatie-informatie
Organisation Kvk Number=Organisatie KVK-nummer
Organisation Phone=Organisatie telefoon
Organisation Phone Code=Organisatie telefooncode
Organisation Phone Number=Organisatie telefoonnummer
Organisation Setting Language=Organisatie instellingstaal
Organisation Settings=Organisatie-instellingen
Organisation Type=Organisatietype
Organisation Type Name=Naam organisatietype
Organisation Types=Organisatietypen
Organisation VATNumber=Organisatie BTW-nummer
Organisation:=Organisatie:
Overwrite=Overschrijven
Overwrite Existing Form=Bestaand formulier overschrijven
Page name cannot be empty.=Paginanaam mag niet leeg zijn.
Pending=In afwachting
Phone Number=Telefoonnummer
Phone should contain 9 digits=Telefoonnummer moet 9 cijfers bevatten
Photo=Foto
Product Service Tile Name=Product- of servicetitel naam
Profile=Profiel
profile Image=Profielafbeelding
Profile Image=Profielafbeelding
QR code=QR-code
Re - Send Invitation=Opnieuw uitnodigen versturen
Receive notifications by=Ontvang meldingen via
Reception=Receptie
Receptionist Given Name=Voornaam receptionist
Receptionist Image=Afbeelding receptionist
Receptionist Last Name=Achternaam receptionist
Receptionist Phone Code=Telefooncode receptionist
Receptionist Phone Number=Telefoonnummer receptionist
Recipient Numbers=Ontvanger nummers
Record '=Record
Record Description=Recordbeschrijving
,</p><p>Welcome to Comforta Software! We are thrilled to have you on board.</p><p>To get started, we need to verify your email address. Please click the button below to activate your account:</p>=,</p><p>Welkom bij Comforta Software! We kijken ernaar uit om u van dienst te zijn.</p><p>Om te beginnen verifiÃ«ren we uw e-mailadres. Klik op de knop hieronder om uw account te activeren:</p>
<br><p>Healthy Living!</p><p>Comforta Software</p></div></div>=<br><p>Hartelijk dank en groeten,</p><p>Comforta Software</p></div></div>
%1 added a comment on a discussion related to: %2={0} heeft een opmerking toegevoegd aan een discussie over: {1}
%1 added by %2 %3={0} toegevoegd door {1} {2}
%1 deleted by %2 %3={0} verwijderd door {1} {2}
%1 updated by %2 %3={0} bijgewerkt door {1} {2}
<p>Once you have activated your account and set a password, you will gain access to the platform.</p>=<p> Zodra je je account hebt geactiveerd en een wachtwoord hebt ingesteld, krijg je toegang tot het platform.</p>
<p>Please note that the link expires in 36 hours.</p>=<p> Houd er rekening mee dat de link over 36 uur verloopt.</p>
1 answer=1 antwoord
Account Updated Successfully=Account succesvol bijgewerkt
WWP_DF_GeneralInformation=Algemene informatie
WWP_DF_Title=Titel
Add element=Element toevoegen
%1 answers={0} antwoorden
WWP_DF_FormVersion=Formulierversie
to=naar
To=naar
TO=naar
Copy=kopiÃ«ren
Type a message...=Typ een bericht...
Block=Blokkeren
Call to Action=Oproep tot actie
Call To Action=Oproep tot actie
Call To Action Email=Oproep tot actie e-mail
Call To Action Phone=Oproep tot actie telefoon
Tile Name=Tegelnaam
WWP_DF_Control=Besturing
WWP_DF_Format=Opmaak
Any=Welke dan ook
Any record=Elk record
WWP_DF_Lenght=Lengte
WWP_DF_DefaultValue=Standaardwaarde
WWP_DF_FormSettings=Formuliervoordelingen
WWP_DF_AddElement=Voeg element toe
WWP_DF_AddStep=Voeg stap toe
WWP_DF_AddValidation=Voeg validatie toe
Add Element=Element toevoegen
WWP_DF_FormReferenceIsRequired=Formulierreferentie is vereist
WWP_DF_ControlType=Type besturing
Text=Tekst
Text Color=Tekstkleur
Textarea=Tekstgebied
textColor=Tekstkleur
Date picker=Datumkiezer
Switch (on/off)=Schakelaar (aan/uit)
Checkbox=Selectievakje
Predefined options=Vooraf gedefinieerde opties
PredefinedPages/Published=Vooraf gedefinieerde pagina's/Gepubliceerd
WWP_DF_Decimals=Decimalen
WWP_DF_DecimalsGreater5=Decimalen groter dan 5
WWP_DF_IncludeTime=Tijd opnemen
WWP_DF_SetTodayAsDefaultValue=Stel vandaag in als standaardwaarde
WWP_DF_CheckboxText=Tekst van het selectievakje
WWP_DF_AllowMultipleSelection=Meerdere selecties toestaan
Combo box=Keuzelijst
WWP_DF_Combo=Keuzelijst
WWP_DF_RadioButtons=Keuzerondjes
WWP_DF_TextWithSuggestions=Tekst met suggesties
Web Notification Status=Webmeldingstatus
Web service=Webservice
Website=Website
WWP_DF_Options=Opties
WWP_DF_OptionsType=Optie type
WWP_DF_IncludeEmptyValue=Lege waarde opnemen
General Supplier Updated successfully=Algemene leverancier succesvol bijgewerkt
General Supplier Inserted successfully=Algemene leverancier succesvol ingevoegd
General Supplier Deleted successfully=Algemene leverancier succesvol verwijderd
Account Updated Successfully.=Account succesvol bijgewerkt
Account Activation Complete=Accountactivatie voltooid
Block Resident=Bewoner blokkeren
You have 5 new notifications=Je hebt 5 nieuwe meldingen
You have filled out a form (=Je hebt een formulier ingevuld
Set Account Password:=Stel accountwachtwoord in:
WWP_GAM_Password=Wachtwoord
WWP_GAM_PasswordAndConfirmationDontMatch=Wachtwoord en bevestiging komen niet overeen
WWP_GAM_PasswordChangedSuccesfully=Wachtwoord succesvol gewijzigd
WWP_GAM_PasswordConfigurations=Wachtwoordinstellingen
WWP_GAM_Passwordconfirmation=Wachtwoordbevestiging
WWP_GAM_PasswordNeverExpires=Wachtwoord verloopt nooit
WWP_GAM_PasswordNotMatch=Wachtwoorden komen niet overeen
WWP_GAM_PasswordSavedSuccessfully=Wachtwoord succesvol opgeslagen
Copy To Location=KopiÃ«ren naar locatie
Select Organisation=Selecteer organisatie
Type a message to create a new thread...=Typ een bericht om een nieuw gesprek te starten...
Type a code=Typ een code
Call To Actions=Oproepen tot actie
Call to Subscribe Resident User=Oproep om resident-gebruiker in te schrijven
Call To Action Url=Oproep tot actie-URL
Call To Action Type=Oproep tot actie-type
Call To Action Phone Number=Oproep tot actie telefoonnummer
Call To Action Phone Code=Oproep tot actie telefooncode
Class=Klas
Supplier=Leverancier
WWP_DF_ImportForm=Importeer formulier
WWP_DF_Import_Success=Importeren geslaagd
WWP_DF_ExportForm=Exporteer formulier
WWP_DF_FillOutAForm=Vul een formulier in
WWP_DF_CopyForm=Kopieer formulier
WWP_DF_Copy_Success=KopiÃ«ren geslaagd
You don't have the required permissions to access this page. Please contact your manager.=Je hebt niet de juiste rechten om deze pagina te openen. Neem contact op met je manager.
Group=Groep
Group RSVP=Groeps-RSVP
Salutation=Aanhef
UNREAD MESSAGES=ONGELEZEN BERICHTEN
Return=Terug
WWP_Calendar_Past=Verleden
WWP_Calendar_Range=Bereik
Profile updated sucessfully=Profiel succesvol bijgewerkt
Services=Diensten
WWP_DF_ElementSettings=Elementinstellingen
WWP_DF_ElementType=Elementtype
Send Mail=Verstuur e-mail
Send Notification=Verstuur melding
Send OTP=Verstuur OTP
Send Pending Notifications=Verstuur wachtende meldingen
Send SMS=Verstuur SMS
Send Web Notification=Verstuur webmelding
Sender Address=Afzenderadres
Sender Name=Afzendernaam
Sender Number=Afzendernummer
Sending activation email failed -=Verzenden van activatie-e-mail mislukt -
Sending password reset email failed -=Verzenden van wachtwoordreset-e-mail mislukt -
WWP_DF_Settings=Instellingen
Grant access to apply 'Dynamic Forms'=Verleen toegang om 'Dynamische formulieren' toe te passen
Grant access to the 'My Care' category=Toegang verlenen tot de categorie 'Mijn Zorg'
Grant access to the 'My Living' category=Toegang verlenen tot de categorie 'Mijn Wonen'
Grant access to the 'My Services' category=Toegang verlenen tot de categorie 'Mijn Diensten'
My Care=Mijn Zorg
my care=mijn zorg
WWP_DF_Visibility=Zichtbaarheid
WWP_DF_VisibleCondition=Zichtbare staat
WWP_DF_VisibleConditionNotValid=Zichtbare toestand niet geldig
WWP_DF_VisibleConditionTooltip=Zichtbare conditie-tooltip
WWP_DF_IsRequired=is vereist
Submit=Indienen
Service=Dienst
AGB Supplier Deleted successfully=AGB-leverancier succesvol verwijderd
AGB Supplier Inserted successfully=AGB-leverancier succesvol toegevoegd
AGB Supplier Updated successfully=AGB-leverancier succesvol bijgewerkt
Content page saved successfully=Inhoudspagina succesvol opgeslagen
Deleted location successfully=Locatie succesvol verwijderd
Deleted organisation successfully=Organisatie succesvol verwijderd
Location Deleted successfully=Locatie succesvol verwijderd
Location Inserted successfully=Locatie succesvol ingevoegd
Location License=Locatielicentie
Location license updated successfully=Locatielicentie succesvol bijgewerkt
Location Updated successfully=Locatie succesvol bijgewerkt
Manager Blocked sucessfully=Manager succesvol geblokkeerd
Manager Deleted successfully=Manager succesvol verwijderd
Manager Unblocked sucessfully=Manager succesvol gedeblokkeerd
Manager Updated successfully=Manager succesvol bijgewerkt
Memo created successfully=Memo succesvol aangemaakt
Organisation Created successfully=Organisatie succesvol aangemaakt
Organisation Deleted successfully=Organisatie succesvol verwijderd
Organisation Dynamic Form=Organisatie Dynamisch Formulier
Organisation Dynamic Form Id=Organisatie Dynamisch Formulier-ID
Organisation Inserted successfully=Organisatie succesvol ingevoegd
Organisation Updated successfully=Organisatie succesvol bijgewerkt
Page Save Successfully=Pagina succesvol opgeslagen
Pages Save Successfully=Pagina's succesvol opgeslagen
Password changed successfully=Wachtwoord succesvol gewijzigd
Provisions updated successfully=Bepalingen succesvol bijgewerkt
Receptionist Deleted successfully=Receptioniste succesvol verwijderd
Receptionist Inserted successfully=Receptioniste succesvol ingevoegd
Receptionist Updated successfully=Receptioniste is succesvol bijgewerkt
Resident Deleted successfully=Bewoner succesvol verwijderd
Resident Inserted successfully=Bewoner succesvol ingevoerd
Resident Updated successfully=Resident succesvol bijgewerkt
Saved successfully=succesvol opgeslagen
Service Deleted successfully=Dienst succesvol verwijderd
service Inserted successfully=Service succesvol ingevoegd
Service Inserted successfully=Service succesvol ingevoegd
Service name already exist=Servicenaam bestaat al
Service name Already exists=Servicenaam bestaat al
Service Tile Name=Service Titelnaam
Service Updated=Service bijgewerkt
Service Updated successfully=Service succesvol bijgewerkt
New Updates Available=Nieuwe updates beschikbaar
New Discussion Message=Nieuw discussiebericht
GXM_uploadfileoption=Bestand Uploaden
GXM_uploadurioption=Web adres (URL)
GXM_fileupload_cancelone=Annuleer
GX_BtnEnter=Bevestig
GXM_captionconfirm=Bevestig
GXM_uploadconfirmoption=Bevestig
GXM_Confirm=Bevestig
GXM_insert=Invoegen
Access Rights Name=Toegangsrechten Naam
Access rights Name=Toegangsrechten Naam
Access rights=Toegangsrechten
Provisioning Information=Provisionering Informatie
GX_BtnCancel=Annuleer
GX_BtnSearch=Zoeken
Supplier Type=Leveranciers type
Your account has been activated, proceed to login on the mobile application=Uw account is geactiveerd, ga verder met inloggen op de mobiele applicatie
Your activation link has expired, Please contact the manager=Uw activeringslink is verlopen. Neem contact op met de manager
Your Brand Theme=Jouw merkthema
Your password has been reset, proceed to login on the mobile application=Uw wachtwoord is opnieuw ingesteld, ga verder met inloggen op de mobiele applicatie
WWP_DF_MoveUp=Verplaats Omhoog
WWP_DF_MoveDown=Verplaats Omlaag
WWP_DF_MoveDownElement=Element naar beneden verplaatsen
WWP_DF_MoveStepLeft=Verplaats stap naar links
WWP_DF_MoveStepRight=Verplaats stap naar rechts
WWP_DF_MoveUpElement=Element omhoog verplaatsen
Delete form=Verwijder Formulier
delete sucessfully=Verwijderen geslaagd
delete-avatar=Verwijder avatar
Deleted In=Verwijderd in
deleted.=Verwijderd.
Delivered By=Afgeleverd door
Delete event=Verwijder evenement
Delegate Authorization Version=Versie gedelegeerde autorisatie
NO=Nee
No forms found=Geen formulieren gevonden
WWP_DF_Copy_SuccessTitle=Het formulier is succesvol gekopieerd
GXM_del=Ongeldige verwijdering, gerelateerde informatie
GXM_DeletePhoto=Verwijder foto
GXM_deleterow=Verwijder rij
GXM_DeleteVideo=Verwijder video
GXM_Deleting=Verwijderen
GXM_fileupload_addfiles=Bestand toevoegen
General Supplier Type=Algemeen Leverancier type
Supplier Type Name=naam van het leverancierstype
WWP_GAM_ForgotPassword=Wachtwoord vergeten?
WWP_GAM_Keepmeloggedin=Blijf ingelogd
Back To Login=Terug naar inloggen
Comfirm Password=Bevestig wachtwoord
WWP_GAM_Email=Email
password=Wachtwoord
GX_BtnDelete=Verwijderen
GXM_display=Weergeven
General Dynamic Form=Algemeen Dynamisch Formulier
Location Dynamic Form=Locatie Dynamisch Formulier
Supplier Dynamic Form=Leverancier Dynamisch Formulier
Are you sure you want to delete form?=Weet u zeker dat u dit formulier wilt verwijderen?
Are you sure you want to delete form? All submitted responses will be deleted as well.=Weet u zeker dat u dit formulier wilt verwijderen? Alle ingediende antwoorden zullen ook worden verwijderd.
Add validation=Validatie toevoegen
Validation message=Validatiebericht
Validation condition=Validatievoorwaarde
Test condition=Testvoorwaarde
Form settings=Formulierinstellingen
WWP_DF_ElementType_Container=Container
WWP_DF_ElementType_ElementsRepeater=Elementenherhaler
WWP_DF_Validations=Validaties
WWP_DF_ValidationMessage=Validatiebericht
WWP_DF_ValidationCondition=Validatievoorwaarde
WWP_DF_UserName=Gebruiker Naam
WWP_DF_Type_DynamicSection=Dynamische Sectie
WWP_DF_UnknownError=Onbekende fout
WWP_DF_Type_DynamicForm=Dynamisch Formulier
WWP_DF_TitleType=Titeltype
WWP_DF_TestCondition=Testvoorwaarde
WWP_DF_Style=Stijl
WWP_DF_Step=Stap
WWP_DF_SetNowAsDefaultValue=Stel nu in als standaardwaarde
WWP_DF_ServiceURL=Service URL
WWP_DF_ResumeMessage=Hervattingsbericht
WWP_DF_ResumeFilledOutForm=Hervat ingevuld formulier
WWP_DF_Resume_Never=Nooit
WWP_DF_Resume_AskUser=Vraag de gebruiker
WWP_DF_Resume_Always=Altijd
WWP_DF_RepetitionsValue=Herhalingswaarde
WWP_DF_RepetitionsType=Herhalingstype
WWP_DF_RepetitionsCountVariable=Herhalingstelvariabele
WWP_DF_ReferenceMustBeUnique=De referentienaam moet uniek zijn.
WWP_DF_MaxRepetitions=Maximum Herhalingen
WWP_DF_LabelMetadata_Style_Title=Titel
WWP_DF_LabelMetadata_Style_Text=Tekst
WWP_DF_InvalidURL=Ongeldige URL.
WWP_DF_InvalidMailAddress=Ongeldig e-mailadres.
WWP_DF_ErrorCloning=Fout bij het klonen van een formulier
WWP_DF_EnterConditionToValidate=Voer een voorwaarde in om te valideren
WWP_DF_EmptyText=Lege tekst
WWP_DF_ElementType_Step=Stap
WWP_DF_ElementType_Simple=Eenvoudig
WWP_DF_ElementType_Label=Label
WWP_DF_ElementRepeater_Type_Plain=Gewoon
WWP_DF_ElementRepeater_Type_Grid=Grid
WWP_DF_ElementRepeater_Repetitions_Variable=Variabele
WWP_DF_ElementRepeater_Repetitions_FixedValue=Vaste Waarde
WWP_DF_ElementRepeater_Repetitions_AddedByUser=Toegevoegd Door Gebruiker
WWP_DF_ElementCaptionType_Title=Titel
WWP_DF_ElementCaptionType_Label=Label
WWP_DF_DisplayType=Weergavetype
WWP_DF_Description=Beschrijving
WWP_DF_DeleteFormMessage=Weet u zeker dat u dit formulier wilt verwijderen?
WWP_DF_DeleteFormTitle=Verwijder Formulier
WWP_DF_Date=Datum
WWP_DF_DataType_Url=Url
WWP_DF_DataType_Password=Wachtwoord
WWP_DF_DataType_Numeric=Numeriek
WWP_DF_DataType_Image=Afbeelding
WWP_DF_DataType_File=Bestand
WWP_DF_DataType_Email=Email
WWP_DF_DataType_Datetime=Datumtijd
WWP_DF_DataType_Date=Datum
WWP_DF_DataType_Character=Teken
WWP_DF_DataType_Boolean=Boolean
WWP_DF_DataColumns=Gegevenskolommen
WWP_DF_ContainerMetadata_Style_PanelWithTitle=Paneel met titel
WWP_DF_ContainerMetadata_Style_Panel=Paneel
WWP_DF_Container=Container
WWP_DF_ConfirmSelectedElementDeletion=Weet u zeker dat u het geselecteerde element wilt verwijderen?
WWP_DF_ConfirmCurrentElementDeletion=Weet u zeker dat u het huidige element wilt verwijderen?
WWP_DF_ConditionExecSuccessfully=Voorwaarde succesvol uitgevoerd
WWP_DF_Checkboxes=Selectievakjes
WWP_DF_CharControlType_Text=Tekst
WWP_DF_CharControlType_TextArea=Tekstgebied
WWP_DF_CharControlType_MultipleOptions=Meerdere Opties
WWP_DF_CharControlType_HTMLEditor=HTML Editor
WWP_DF_Char_MultipleOptions_ControlType_Suggest=Suggereren
WWP_DF_Char_MultipleOptions_ControlType_ComboBox=Keuzelijst
WWP_DF_Char_MultipleOptions_ControlType_RadioButton=Radioknop
WWP_DF_Char_MultipleOptions_ControlType_CheckBox=Selectievakje
WWP_DF_Boolean_ControlType_CheckBox=Selectievakje
WWP_DF_Boolean_ControlType_Switch=Schakelaar
Copy form=Formulier kopiÃ«ren
Are you sure you want to copy the form?=Weet u zeker dat u het formulier wilt kopiÃ«ren?
WWP_DF_ExcludeFromExport=Uitsluiten van export
WWP_DF_ContainerMetadata_Style_None=Geen
WWP_DF_ElementCaptionType_None=Geen
WWP_DF_ReferenceId=Referentie ID
WWP_DF_DeleteElement=Element verwijderen
The receptionists manage a location, the location residents, build the app, etc=De receptionisten beheren een locatie, de locatiebewoners, bouwen de app, enz.
The residents are the occupants of a location (e.g. clients, guests, tenants etc...)=De bewoners zijn de gebruikers van een locatie (bijv. cliÃ«nten, gasten, huurders enz.).
Receptionist Definitions=Definities van Receptionist
Resident Definitions=Definities van Bewoner
Receptionists:=Receptionisten:
View details=Details bekijken
Send Message=Bericht verzenden
NOTIFICATIONS=MELDINGEN
Agenda Calendar Type=Agenda Kalender Typen
Agenda/Calendar=Agenda/Kalender
APPS PROVISIONED=GEPROVISIONEERDE APPS
FILLED FORMS=INGEVULDE FORMULIEREN
Filled Out Forms=Ingevulde formulieren
Filled by=Ingevuld door
Types=Typen
WC_Create Supplier Form=Maak leveranciersformulier aan
